6	4	1	7	3	6	9	1	4	2	2	5	6	3	7
3	9	9	3	4	9	8	9	3	3	2	8	2	2	9
7	4	6	5	6	6	4	7	8	3	1	#	4	2	5
9	9	2	5	7	4	4	6	4	3	#	9	1	2	3
1	8	3	9	4	1	2	7	3	7	2	3	4	5	9
#	1	9	5	2	8	3	5	5	7	9	2	2	4	6
5	S	5	9	7	2	3	4	2	2	7	9	9	1	4
3	7	3	#	4	1	9	6	3	6	1	5	5	7	8
#	2	3	#	#	2	4	3	5	2	9	9	3	#	2
8	4	1	6	9	1	#	4	5	#	6	6	2	5	7
8	7	#	9	4	5	3	5	#	3	#	4	2	G	1
4	7	9	1	8	1	9	3	4	7	7	4	#	6	7
4	3	7	8	2	5	6	9	7	6	3	1	4	8	2
8	2	2	9	7	7	7	8	6	9	2	1	9	5	#
#	9	6	#	7	3	4	8	6	3	1	8	8	2	2
