3	3	8	4	6	8	8	8	#	3	5	#	3	1	8	4	2	8	S	2
5	1	#	6	6	7	#	6	6	5	3	4	1	3	9	1	5	9	3	7
7	5	5	2	2	2	#	6	8	1	1	6	8	9	6	5	4	3	8	2
3	3	8	4	5	1	5	5	2	#	3	2	2	2	4	6	8	7	2	3
6	6	5	6	5	8	4	7	7	5	6	3	2	7	8	1	1	9	5	8
4	#	4	7	3	5	4	4	3	1	1	3	3	2	3	8	4	8	4	8
3	6	9	6	1	6	2	#	5	7	2	2	1	1	5	3	2	3	7	6
9	4	9	1	7	3	4	7	2	6	6	6	5	6	5	#	6	4	1	9
3	6	5	2	2	3	#	2	3	6	2	8	3	9	#	8	2	2	5	9
7	6	1	7	1	1	3	4	2	6	3	7	8	#	3	9	3	8	5	4
7	9	7	8	2	2	3	4	5	8	9	2	9	7	2	1	5	2	6	9
5	2	9	7	3	7	1	4	1	1	2	9	6	5	3	3	5	5	2	7
7	4	1	G	7	#	7	6	8	5	7	9	7	6	1	4	5	5	9	9
4	4	#	4	6	7	1	7	2	9	1	8	8	8	1	5	1	6	2	2
5	4	6	2	9	7	9	3	6	1	#	2	6	1	5	1	#	2	8	7
2	4	#	3	8	5	9	7	3	2	5	8	1	3	2	6	5	7	5	8
4	5	7	1	6	5	8	6	4	#	8	4	#	2	1	6	5	1	8	5
5	7	9	2	9	4	7	4	1	8	1	6	6	2	7	6	9	9	4	5
4	7	5	9	1	5	3	9	9	8	9	#	1	4	3	8	5	1	2	6
7	1	4	7	4	6	9	3	9	2	7	6	5	7	7	3	9	4	6	1
