4	4	1	4	G
9	5	4	5	3
#	8	2	2	1
4	1	1	9	3
7	S	4	7	3
