3	5	5	3	2	2	4	5	8	5
G	1	6	2	#	2	2	6	9	2
2	8	5	3	1	4	8	7	8	2
4	1	3	4	5	6	2	2	8	1
4	2	1	6	8	1	6	2	8	2
#	6	6	1	8	7	7	3	9	5
1	8	8	2	7	3	5	9	1	2
8	2	4	6	7	3	3	8	9	8
3	S	4	8	5	8	5	6	5	7
8	3	4	3	5	8	8	4	5	5
