#	#	7	8	7
9	#	4	#	4
#	#	5	9	#
7	G	5	#	7
1	#	#	S	8
